111111111111111111111111
1P0000000000010C00000001
1000111111000011111100E1
100010000100000C00010001
1C000000000000C000000001
111111111111111111111111