11111111111111111111
1P0000000000000000C1
10001111111111111001
1C001000000000000001
10001111111111111001
10100000000000000001
10001111111111111001
1C0000000000000000E1
10001111111111111001
10100000000000000001
10001111111111111001
1C000000000000000001
10001111111111111001
10100000000000000001
10001111111111111001
1C000000000000000001
10001111111111111001
10100000000000000001
10001111111111111001
11111111111111111111