1111111111111111111111111111111111111111
1P0000000000010C0000000000000000000000C1
1000111111000011111100001111110000110C01
100010000100000C0001000000C0010000100001
1000100001000011111100001111110000100001
10001000010000000001000000C0010000100001
1000100001000011111100001111110000100001
1000100001000000000100000000010000100001
100010000100001111110000111111000010C001
1000100001000000000100000000010000100001
1000100001000011111100001111110000100001
10001000010000000001000000C0010000100001
1000100001000011111100001111110000100C01
10001000010000000001000000C0010000100001
1000100001000011111100001111110000100001
1000100C01000000000100000000010000100001
1000100C01000011111100C01111110000100001
1000100001000000000100000000010000100001
10001000010000111111000011C1110000100001
1000100001C0000000010C000000010000100001
1000100001000011111100001111110000100C01
1000100001000000000100000000010000100001
1000100001000011111100001111110000100001
100010000100000000010C000000010000100001
1000100001000011111100001111110000100001
100010000100000C000100000000010000100001
1000100001000011111100001111110000100001
1000100001000000000100000000010000100001
1C000000000000C0000000000000C0000CE00011
1111111111111111111111111111111111111111